111111111111111111111111111
1P0000000000000000000000001
101111101111101000101111001
101000001000001100101000101
101111101110001010101000101
100000101000001001101000101
101111101111101000101111001
100000000000000000000000001
101000101000101111001111101
101100101000101000101000001
101010101000101000101110001
101001101000101000101000001
101000101111101111001111101
100000000000000000000000CE1
111111111111111111111111111
